AAAAAAAAAAAAAAAAAAA
AxxxxxxTTxxTxTxxxxA
AxATATAxATAxAxATAxA
AxxxTxTxxxxTxTTxTxA
ATATAxATAxAxAxAxAxA
AxxTxTxTxTTxTxTTTTA
ATAxAxATATATATAxATA
ATTxxxTxTTTxTTxxxTA
AxAxAxAxAxAxATAxAxA
ATxxTTxTxxxTTTxTxTA
AxAxAxAxATATATATATA
ATTxTxxxxxTTxxTxxTA
AxAxAxAxATAxAxATAxA
AxTTTTTTTxxxTTxTxTA
AxAxATAxATATATAxATA
ATxTTxxTTTTxTxxxTTA
AxATATAxATATAxATAxA
AxxxTTxxxxTxTTxxxxA
AAAAAAAAAAAAAAAAAAA