AAAAAAAAAAAAAAAAAAA
A,xTTTTTTxxxxTTxx;A
AxATATATAxATATATAxA
AxxTxxTxTTxxxTxTTTA
ATATATAxAxATAxAxATA
ATTTxTxxxTTTTTxxTTA
AxATAxAxAxATAxAxATA
ATTTxxTTTxxTxxTxxTA
AxAxATAxATATATATATA
AxTTxxTxxxxxxTxxTTA
ATAxAxAxATATAxAxAxA
AxTxxxxTxTxxTTTxTTA
AxAxAxATATAxATATATA
ATTxxTxTxxxxTxTxxTA
AxATAxATAxATATATATA
ATTTxTxTTTxTTTTxTTA
AxATAxATATATATAxAxA
A:xxTxTTTTTTxxxTx!A
AAAAAAAAAAAAAAAAAAA