AAAAAAAAAAAAAAAAAAA
A,xTTTxxxxTxTTxTx;A
AxAxAxAxATAxAxATAxA
AxTxTTTxTxxTxTTTTxA
AxATAxATATAxAxAxATA
AxxTxTxTTTxTTTxxTxA
AxATAxAxATATAxATAxA
AxxxTTxxxTTTTxTTTxA
ATAxATAxAxATAxATAxA
AxxxTTxxTTTxTTTxxxA
AxAxAxAxAxAxATAxATA
AxTxxxxxxTTTxTTTxxA
AxAxATATAxATAxAxATA
ATTTTxTTxTxxTxxxxxA
ATAxAxAxATAxATATATA
ATxxxTxTxTxxxTxxxTA
AxAxAxATAxAxATAxAxA
A:xTxxxxxTxxxxxxx!A
AAAAAAAAAAAAAAAAAAA