AAAAAAAAAAAAAAAAAAA
AxxTxxTTxxxxxTTxxxA
AxATAxAxAxATATATAxA
ATTTxTxxTxxTxxxxxTA
ATAxAxAxAxAxATAxATA
AxTTTxxxxTxxTTxTTxA
AxAxATATATAxATAxATA
AxxTTxxTxxTxTxxTTxA
AxAxATAxATATAxAxAxA
ATTxTxTxxxxxxxxxxTA
AxATAxAxATAxATATAxA
ATTxxTxxxxTTxxxTxTA
AxATAxATATATATAxATA
ATxTTTTTxTxTxxTxxxA
AxAxAxATAxATAxATATA
AxTTxTTTxxxTxTTxxxA
AxATATAxATAxAxAxAxA
AxxxTTxxTTxxxTxTxxA
AAAAAAAAAAAAAAAAAAA