AAAAAAAAAAAAAAAAAAA
AxxTTxxxTTxTTxxTxxA
AxATATATATAxAxATAxA
ATTTTxTxxTTTxxTxxxA
ATATATAxATATATAxATA
AxTxTxTxTTTTxxTTTTA
ATAxAxAxAxATATATAxA
AxTxxTxxxxTxxTxxxxA
ATAxATATATAxATATATA
AxTTTxxTxxTTxxxTxxA
ATATAxAxAxATAxAxATA
ATTTTTTxxTTxxxxTxTA
ATATATATATAxAxAxATA
ATxxTxTxxTxxTxxTTTA
AxATATAxAxAxAxAxATA
AxTTxxTxTTTTTTxTxxA
AxAxAxAxATAxAxATAxA
AxxTxTTxTxxxxxxTxxA
AAAAAAAAAAAAAAAAAAA