AAAAAAAAAAAAAAAAAAA
AxxxxxxxxTxTTxTTxxA
AxAxATAxATATATATAxA
ATTTTxxxTxxxTTTxTxA
AxAxAxATATATATATATA
ATTTTTxTTxxxTTxxTTA
ATAxATATAxATAxATATA
AxTTTTxxTxxxTTTxTTA
ATATAxAxAxAxATAxAxA
AxxxTTxxxTxxxTTTTTA
AxAxATAxAxATATATATA
ATxTTxTTTTTxxTxTTxA
AxATAxATAxAxAxATAxA
ATTxxxTxxTxTTxxTTTA
ATATAxATAxAxAxAxAxA
ATTxxxxTTxTTTxxTTTA
AxAxAxATATAxATAxAxA
AxxTxTTTTxTTTTxxxxA
AAAAAAAAAAAAAAAAAAA