AAAAAAAAAAAAAAAAAAA
AxxTxTTTTTxTTTTxxxA
AxATATAxATAxAxATAxA
AxTxTTTxTxxTxTTTTxA
ATATAxAxAxATAxATATA
AxxTxxTxTTxxTTTTxxA
ATATAxAxAxATAxATATA
ATTxTTxxxxTxTxTTxTA
ATATATAxAxAxAxAxATA
ATxTTTTTxTxTTTTTxTA
ATATATAxAxATAxAxATA
ATTTxxxTTxxTTxxTTxA
ATATATAxAxATATATATA
AxTxxTxxTxTTTxxTTxA
ATAxATATATAxATATAxA
AxTxxTTxTxTxTTTTxTA
AxATAxAxAxATAxAxAxA
AxxTxTTxxTxTxxxxxxA
AAAAAAAAAAAAAAAAAAA