AAAAAAAAAAAAAAAAAAA
A,xxxxxTxTxTTTTTx;A
AxATAxAxATATATATAxA
AxxxxTTxTTTTxTxTxTA
AxAxAxAxAxATAxATAxA
ATTTxxTxxTxxTxTTxTA
AxAxATATATATATAxAxA
AxTTxTTxxTTxTTxxxxA
AxAxAxAxAxAxATATAxA
ATxTTTTTxxxTTxxTxTA
AxATAxAxAxAxATAxATA
ATTTTTTxTTTTTxTTTxA
ATAxAxATAxAxAxAxATA
AxxxxxTxxTTxTxxTTTA
AxATAxAxATATAxAxATA
AxxTTTTTxxxxTxTTTTA
AxAxAxAxATATAxAxAxA
A:xxxxTxTxTTxTxxx!A
AAAAAAAAAAAAAAAAAAA