AAAAAAAAAAAAAAAAAAA
A,xTxxTxTTTTxxTxx;A
AxATATAxAxATAxAxAxA
ATTxTTTxTxTTxxTxTTA
ATAxATAxATAxATAxAxA
AxxTTxxTTTTTTxTxTTA
AxAxATAxATATATATAxA
AxTTxxTTTxTxxxTTTTA
AxATATAxAxAxAxAxATA
ATTxxxTTxTTxTxxxTxA
AxAxATATAxAxAxATAxA
AxxTxTxxTxxTxTxTxTA
AxAxATAxAxATATAxATA
ATxxxxTTTxTTTxTxTxA
AxAxAxATAxAxAxATATA
ATxxxxxTxTxxTxTTxTA
AxAxAxAxAxAxAxATAxA
A:xxxTTxTxxxxTTxx!A
AAAAAAAAAAAAAAAAAAA