AAAAAAAAAAAAAAAAAAA
Axxxxxxxxx:TxxTTx;A
AxA,AxATATAxATAxAxA
AxxxTxxxxxTTxTxTTxA
AxAxAxAxATATAxAxAxA
AxxTTTTTxxxxxTTxTTA
AxATAxAxATATAxATATA
AxxxTTxTxxxxxTTxxTA
AxAxATAxATAxAxAxAxA
AxTTxxTTxTxxTTxxxxA
AxAxATATATATATATAxA
AxxxxTTTxxxxTTTTTTA
AxAxAxAxATAxAxAxATA
AxxxTTTxTxTTxxxTTTA
AxATAxAxATAxATATA!A
AxxTTTxxxTTTTTTTxxA
AxATATAxAxATAxAxAxA
A:xTxxxTTTxxTxTxx!A
AAAAAAAAAAAAAAAAAAA
