AAAAAAAAAAAAAAAAAAA
A,xTxxTxTxxxTTxxx;A
AxAxAxATATATAxATAxA
ATxxxxTTTxxxTTTTTxA
ATATAxAxAxATAxAxATA
AxxTTTxTxxTTxxTxxxA
ATAxAxATAxAxAxAxAxA
ATTxxxTTTxxxTTTxxxA
AxATATAxATATAxAxAxA
AxTxTxTTxTTxxTTTxTA
ATAxATATAxATAxAxATA
AxTTTTxTTxTTxxTxTTA
AxAxATAxAxATATAxATA
ATxTTTTxxxxxTxTTTxA
ATATAxAxATAxAxATATA
ATxTTxxxxxTTxTxxxxA
AxAxAxATATATAxAxAxA
A:xTTTTTTxxTTTxxx!A
AAAAAAAAAAAAAAAAAAA