AAAAAAAAAAAAAAAAAAA
A,xxTTxTTxTxTTTxx;A
AxAxATATATAxAxAxAxA
AxxxTxTTTxTTTTxTxxA
AxAxAxATAxAxATAxATA
AxxTxTxTxTxxxTTTxTA
AxAxAxAxATAxAxATATA
AxTTxTxTTTTxxTTTxTA
AxATATAxAxAxATAxAxA
ATTTTTxxxxxTTxTxxxA
AxATAxATATATAxAxAxA
AxTxxTTTTTxxTxTTTTA
ATATATATAxATATAxATA
ATxxxxTTTTxxxxTxxxA
ATAxAxAxAxAxATAxAxA
AxTxTTTxTxTTTTTxTxA
AxATAxAxATAxATAxAxA
A:xTxTTxTTTTxxxTx!A
AAAAAAAAAAAAAAAAAAA