AAAAAAAAAAAAAAAAAAA
AxxxxxTTTTxTTxTxxxA
AxATAxAxAxATATATAxA
AxTxxTTTTTTTxxxTTTA
ATATATATATAxATAxAxA
ATxTTTTxxxxTxxTTTxA
AxATATAxATATATATAxA
AxTTTTxTTxTxTTTTxxA
ATAxAxAxATAxAxAxATA
ATTTxTTTTTxTTxTxTxA
ATATAxATAxATAxAxATA
AxxTxxTTxTTTTxTxxTA
AxAxATATATATAxAxAxA
ATxTxTTTTTxxTTxxxxA
ATATATAxATATATATAxA
AxTTTxTTTxTxTxxxxxA
AxAxATAxATATAxAxAxA
AxxxxxTTTxTTxxxxxxA
AAAAAAAAAAAAAAAAAAA