AAAAAAAAAAAAAAAAAAA
AxxxTxxTTxTxxTxTxxA
AxAxATAxAxATAxAxAxA
AxTTxTxTTTTTxTTxxTA
ATATAxATAxAxATATAxA
AxxTTTxTTxxxxTTxxxA
AxAxAxAxAxAxAxAxATA
ATxTxxTxxxxTTTxxTTA
AxATATAxATAxATATATA
AxTxxxTTxTxxTxTTxxA
AxATATATAxATAxATATA
AxTxTxTxTxTxxxxxTTA
AxAxAxAxATATATATATA
ATTxTxTTxxTTTxxTTxA
AxAxATATATAxATAxAxA
AxTxxTTxxxxxTTTxTTA
AxAxATATATATAxATAxA
AxxTxxxxxTxTxTTTxxA
AAAAAAAAAAAAAAAAAAA