AAAAAAAAAAAAAAAAAAA
A,xTxTxxxxxTTTxTx;A
AxATAxATAxATATATAxA
AxTTxTxxxTTxxxTxTxA
ATAxAxATAxATAxATAxA
AxxTxTTxTxTTTxxTTxA
AxATATATAxAxATAxATA
ATxxxTxTxTTxxTxTTTA
ATATAxAxATAxAxAxATA
AxxxxTTxTxxxTTTTxxA
ATATATATAxAxAxAxATA
ATxTTxxTTTTTxxxxxTA
ATATATATAxAxATAxAxA
ATxTxTxTTxxxTTTTxTA
AxATAxATATAxATATATA
AxTTTxxxxTxTxTxxTTA
AxATATATAxATAxAxAxA
A:xxTTxTxxxTxxxTx!A
AAAAAAAAAAAAAAAAAAA