AAAAAAAAAAAAAAAAAAA
AxxTxxTTTxTTxTTTxxA
AxATAxAxATATATATAxA
ATTxxxxTTxxxxxTTTxA
ATAxATAxATAxATAxAxA
AxxTTTTxTxxxxxTTTxA
AxAxATATAxAxATAxAxA
AxxxxxxTxTTTxTxTTxA
AxATAxAxAxATAxAxATA
AxxxTTTxxxTxxxTTTTA
ATAxATAxATATATATAxA
ATxxTTTTxxTxxTxxxTA
ATAxAxAxATAxAxATATA
ATxxTxxxxTxxTxTxxxA
AxATATAxATAxATAxATA
ATxTTTTxTxTxTxTTTTA
AxAxATAxAxAxATAxAxA
AxxxTxTxTTxxxxTxxxA
AAAAAAAAAAAAAAAAAAA