AAAAAAAAAAAAAAAAAAA
AxxxTTxTxTTTxTTxxxA
AxATATATATAxAxATAxA
ATTxTTxTTxTTxTxTTTA
ATAxATATAxATAxAxATA
AxxxTxTxxTTTTTxxTTA
AxATATATAxATAxAxATA
AxTxTTTxxxTxTTTTxTA
AxATATAxAxAxATAxATA
AxxxTTxTTxTTTTxxTxA
AxAxAxATATAxAxAxATA
AxxxTxTTxxxxTxTxTTA
AxATATATATAxAxATAxA
AxTxTTTTTTxxTxxxxxA
ATATATATATATATATAxA
ATTxTTTxTTTTTxTTTTA
AxATAxATAxATATATAxA
AxxxxxTTxxxTTxTTxxA
AAAAAAAAAAAAAAAAAAA