AAAAAAAAAAAAAAAAAAA
A,xTxxTxxxTTTxTxx;A
AxATAxATATATATATAxA
AxTxxTxTxxxxxTTxTTA
AxATATATAxATAxATAxA
ATxxxxTTxxTxxTxTTTA
AxATAxATATATATAxATA
ATxxTTTTTTxxxTxTTTA
ATATATAxAxAxATAxATA
AxxTTxTxxTxxxTTxTxA
ATATATAxATATATAxAxA
AxTTTxxxxxTTTTxTxxA
ATATAxATAxATAxATATA
AxxTTxxxxTTxxTTTxTA
AxATAxAxAxATATAxAxA
AxxxxxTxxxxTTxxxTTA
AxAxATATAxAxAxATAxA
A:xxxxTxxTxxTTTTx!A
AAAAAAAAAAAAAAAAAAA